###############################
#S           #                #
#            #                #
#   ##########        W       #
#       #                     #
#       #                     #
#       #        ##############
#       #        #      #     #
#       #           #      #  #
#       #        ###########  #
#       #   W    #            #
#       #        #    #########
#                #            #
#  F             ##########   #
#                #            #
#                #            #
###############################
