###################
#                 #
#                 #
#           B     #
#      WWW        #
#      WFW        #
#      WWW        #
#                 #
###################