###################
#        EE       #
#        EE       #
#        WB       #
#WWW     FB    BBB#
# E      WW       #
#                 #
#                 #
###################