###################
#                 #
#                 #
#      EE   B     #
#      WWW        #
# E    WFW        #
#      WWW        #
#                 #
###################